#........X
..#######.
#....####.
####.####.
####.####.
####.####.
####.####.
####.####.
####.####.
..........