.........#..........
.........#......X...
.........#..........
.........#..........
.........#..........
.........#..........
.........#..........
.@.......#..........
.........#..........
.........#..........
.........#..........
.........#..........
.........#..........
.........#..........
.........#..........
....................
....................