#####X####
#####.####
#####.####
####...###
####.#.###
####...###
##########
#####.####
#####@####
##########